{
  "0": "o",
  "1": "i",
  "3": "e",
  "4": "a",
  "5": "s",
  "6": "b",
  "7": "t",
  "8": "b",
  "9": "g",
  "@": "a",
  "$": "s",
  "!": "i",
  "|": "l",
  "(": "c",
  ")": "c",
  "+": "t",
  "^": "a",
  "€": "e",
  "£": "l",
  "¥": "y",
  "ph": "f",
  "vv": "w",
  "uu": "w",
  "><": "x",
  "|-|": "h",
  "|_|": "u",
  "/_/": "u",
  "/\\/": "m",
  "|\\|": "n",
  "|/": "n",
  "|-": "f",
  "|=": "f",
  "(|": "d",
  "|)": "d",
  "(3": "e",
  "|3": "b",
  "|-3": "b",
  ")3": "b",
  "13": "b",
  "|2": "r",
  "|?": "r",
  "/2": "r",
  "2": "r",
  "|-|": "h",
  "#": "h",
  "&": "and",
  "\/": "v",
  "\\/": "v",
  "ck": "k",
  "x": "x",
  "z": "s",
  "q": "k",
  "ph": "f",
  "%": "percent",
  "*": "a",
  "¢": "c",
  "©": "c",
  "°": "o",
  "µ": "u",
  "ß": "ss",
  "ä": "a",
  "ö": "o",
  "ü": "u",
  "à": "a",
  "á": "a",
  "â": "a",
  "ã": "a",
  "å": "a",
  "æ": "ae",
  "ç": "c",
  "è": "e",
  "é": "e",
  "ê": "e",
  "ë": "e",
  "ì": "i",
  "í": "i",
  "î": "i",
  "ï": "i",
  "ñ": "n",
  "ò": "o",
  "ó": "o",
  "ô": "o",
  "õ": "o",
  "ø": "o",
  "ù": "u",
  "ú": "u",
  "û": "u",
  "ý": "y",
  "þ": "th",
  "ð": "d"
}
